1111111111111111111111
1C0E01100C10C000000111
1010000C10100011010011
10101001P0000000111001
1C00100111C00110000CE1
1111111111111111111111