11111111
11000011
10C0E001
1000P011
11111111